16 16
++++++++++++++++
+......++......+
+...+..++..+...+
+..s+......+S..+
+.+++......+++.+
+..............+
+.....+..+.....+
+++..........+++
+++..........+++
+.....+..+.....+
+..............+
+.+++......+++.+
+..S+......+s..+
+...+..++..+...+
+......++......+
++++++++++++++++
d