16 8
++++++++++++++++
++............++
++.+++....+++.++
+...s+....+S..F+
+f..s+....+S...+
++.+++....+++.++
++............++
++++++++++++++++
d