17 17
+++++++++++++++++
+...............+
+.....+...+.....+
+..SSS+...+SSS..+
+..SSS+...+SSS..+
+.+++++...+++++.+
+...............+
+...............+
+++++++...+++++++
+...............+
+...............+
+.+++++...+++++.+
+..sss+...+sss..+
+..sss+...+sss..+
+.....+...+.....+
+...............+
+++++++++++++++++
d