32 32
++++++++++++++++++++++++++++++++
+..............................+
+...+..+...+..+..+..+...+..+...+
+..s+..+++++..+..+..+++++..+S..+
+.+++.........+ss+.........+++.+
+.............++++.............+
+......+................+......+
+.++..+++..............+++..++.+
+..+...+................+...+..+
+..+........................+..+
+..+........................+..+
+.++.......+...++...+.......++.+
+...........+......+...........+
+............+....+............+
+.++++........+..+........++++.+
+...S+.....+...++...+.....+S...+
+...S+.....+...++...+.....+S...+
+.++++........+..+........++++.+
+............+....+............+
+...........+......+...........+
+.++.......+...++...+.......++.+
+..+........................+..+
+..+........................+..+
+..+...+................+...+..+
+.++..+++..............+++..++.+
+......+................+......+
+.............++++.............+
+.+++.........+ss+.........+++.+
+..S+..+++++..+..+..+++++..+s..+
+...+..+...+..+..+..+...+..+...+
+..............................+
++++++++++++++++++++++++++++++++
