8 8
++++++++
+sss+ss+
+++s+s++
+ssssss+
+s+ss+s+
+++s++s+
+sss+ss+
++++++++
