8 8
++++++++
+s+...S+
+.+..+++
+......+
+......+
+++..+.+
+S...+s+
++++++++
