8 8
++++++++
+s+ssss+
+s++++++
+s+ss+s+
+s+ss+s+
++++++s+
+ssss+s+
++++++++
